00000000000000000000000000000
05222200022222222222000222250
02000200020000000002000200020
02222222222222222222222222220
00200200000002020000000200200
00200200000002020000000200200
00200422222222022222222400200
00200000020000000002000000200
00222222222222422222222222200
00200000020000000002000000200
00200222220000000002222200200
00200200200000000000200200200
00222200222222222222200222200
00200000000020002000000000200
00200000000020002000000000200
00222222222220002222222222200
00200000200000000000200000200
00200000200000000000200000200
00222222222222322222222222200
00200000020000000002000000200
00200000020002520002000000200
02222222220002020002222222220
02000200020002020002000200020
02222200022222022222000222220
00000000000000000000000000000